MapChip01.bmp
20 50
8 0 0 0 17 17 17 17 17 17 17 17 17 17 17 17 0 0 0 9
8 0 0 0 17 20 17 17 17 13 17 14 17 17 17 17 0 0 0 9
8 0 0 0 17 17 17 17 17 17 17 17 17 20 17 17 0 0 0 9
8 0 0 0 17 17 17 17 17 17 11 17 17 17 17 17 0 0 0 9
8 0 0 0 17 17 17 17 11 17 17 17 17 17 17 17 0 0 0 9
8 0 0 0 17 11 17 21 17 17 17 17 11 17 17 17 0 0 0 9
8 0 0 0 17 17 17 17 17 17 20 17 17 17 17 17 0 0 0 9
8 0 0 0 17 17 17 17 17 17 17 17 17 17 11 17 0 0 0 9
8 0 0 0 17 17 17 17 17 17 17 17 17 17 17 17 0 0 0 9
8 0 0 0 17 17 20 17 17 8 17 17 17 17 17 17 0 0 0 9
8 0 0 0 17 17 17 17 17 17 17 17 21 17 17 17 0 0 0 9
8 0 0 0 22 17 17 17 17 17 11 17 17 17 17 17 0 0 0 9
8 0 0 0 17 17 11 17 17 17 17 17 17 17 17 14 0 0 0 9
8 0 0 0 17 17 17 17 17 17 22 17 17 17 11 17 0 0 0 9
8 0 0 0 11 17 21 17 14 17 17 17 17 14 17 17 0 0 0 9
8 0 0 0 17 17 17 17 17 17 17 17 17 17 17 17 0 0 0 9
8 0 0 0 17 17 17 17 17 17 17 20 17 17 17 17 0 0 0 9
8 0 0 0 17 14 17 17 17 11 17 17 17 17 17 20 0 0 0 9
8 0 0 0 17 17 17 17 17 17 17 17 11 17 17 17 0 0 0 9
8 0 0 0 17 17 17 17 17 21 17 17 17 17 17 17 0 0 0 9
8 0 0 0 17 17 17 17 17 17 17 17 17 17 11 17 0 0 0 9
8 0 0 0 17 17 22 17 17 17 17 17 8 17 17 17 0 0 0 9
8 0 0 0 17 11 17 17 20 17 17 17 17 17 17 17 0 0 0 9
8 0 0 0 17 17 17 17 17 17 17 17 17 17 17 17 0 0 0 9
8 0 0 0 20 17 17 17 11 17 14 17 17 17 11 17 0 0 0 9
8 0 0 0 17 17 17 17 17 17 17 17 17 20 17 17 0 0 0 9
8 0 0 0 14 17 17 11 17 17 17 17 17 17 17 14 0 0 0 9
8 0 0 0 17 17 17 17 17 11 17 17 17 17 17 17 0 0 0 9
8 0 0 0 17 8 17 14 17 17 17 17 17 17 17 17 0 0 0 9
8 0 0 0 17 17 17 17 17 17 17 17 17 17 17 17 0 0 0 9
8 0 0 0 17 11 17 17 17 17 17 17 17 22 17 17 0 0 0 9
8 0 0 0 17 17 17 17 14 17 17 17 17 17 17 17 0 0 0 9
8 0 0 0 17 17 21 17 17 11 17 21 17 17 17 14 0 0 0 9
8 0 0 0 17 17 11 17 17 17 17 17 17 17 17 17 0 0 0 9
8 0 0 0 17 17 17 17 20 17 17 17 20 17 17 17 0 0 0 9
8 0 0 0 20 17 17 17 17 17 17 17 17 17 14 17 0 0 0 9
8 0 0 0 17 17 17 17 17 17 17 17 17 17 17 17 0 0 0 9
8 0 0 0 17 17 17 17 11 17 20 17 17 17 17 17 0 0 0 9
8 0 0 0 17 17 20 17 17 17 17 17 17 17 17 17 0 0 0 9
8 0 0 0 17 17 17 17 17 17 17 17 17 14 17 17 0 0 0 9
8 0 0 0 14 17 17 17 17 22 17 17 17 17 17 17 0 0 0 9
8 0 0 0 17 17 11 17 17 17 17 17 17 17 17 17 0 0 0 9
8 0 0 0 17 17 17 17 17 20 17 17 17 17 17 17 0 0 0 9
8 0 0 0 17 17 17 17 17 17 17 11 20 17 17 17 0 0 0 9
8 0 0 0 17 17 17 21 17 17 17 17 17 17 17 17 0 0 0 9
8 0 0 0 17 17 17 17 17 17 17 17 17 11 17 17 0 0 0 9
8 0 0 0 17 17 17 17 17 17 17 17 17 17 17 17 0 0 0 9
8 0 0 0 17 17 17 17 17 17 17 17 17 17 17 17 0 0 0 9
8 0 0 0 17 17 20 17 17 12 17 17 17 17 21 17 0 0 0 9
8 0 0 0 17 17 17 17 17 17 17 17 17 17 17 17 0 0 0 9
