MapChip01.bmp
20 50
8 0 0 17 17 17 17 17 17 17 17 17 17 17 17 17 17 0 0 8
8 0 0 17 17 17 14 17 17 13 17 17 17 17 17 20 17 0 0 8
8 0 0 17 17 17 17 17 17 17 17 17 14 17 17 17 17 0 0 8
8 0 0 17 17 17 17 17 17 17 17 17 17 17 17 17 17 0 0 8
8 0 0 21 17 11 17 17 11 17 17 17 11 17 14 17 17 0 0 8
8 0 0 8 17 17 17 17 17 17 14 17 17 17 17 17 17 0 0 8
8 0 0 17 8 17 17 17 17 17 17 17 17 17 17 17 17 0 0 8
8 0 0 17 17 17 17 17 17 11 17 17 20 17 11 17 17 0 0 8
8 0 0 17 17 17 17 17 17 17 17 17 17 17 17 17 17 0 0 8
8 0 0 17 17 14 17 8 17 8 17 17 17 17 17 17 17 0 0 8
8 0 0 14 17 17 17 17 8 17 17 17 11 17 17 14 17 0 0 8
8 0 0 17 17 17 17 11 8 17 17 17 17 17 17 17 17 0 0 8
8 0 0 17 17 20 17 17 17 17 14 17 17 17 17 17 17 0 0 8
8 0 0 17 17 17 17 17 17 17 17 17 17 20 17 17 17 0 0 8
8 0 0 17 17 17 17 14 17 17 17 17 17 17 17 17 17 0 0 8
8 0 0 17 17 17 17 17 17 17 11 17 17 17 17 17 8 0 0 8
8 0 0 17 20 17 17 17 17 17 17 17 17 17 17 8 17 0 0 8
8 0 0 17 17 17 17 17 17 17 14 17 17 14 8 17 17 0 0 8
8 0 0 17 17 17 17 17 17 17 17 17 11 17 17 17 17 0 0 8
8 0 0 17 17 14 11 17 17 8 8 8 17 17 17 17 17 0 0 8
8 0 0 17 17 17 17 17 17 17 17 8 17 17 17 17 17 0 0 8
8 0 0 17 17 17 17 17 17 17 17 17 17 17 17 17 14 0 0 8
8 0 0 17 17 17 17 14 17 21 17 17 17 17 17 17 17 0 0 8
8 0 0 14 17 17 17 17 17 17 17 17 17 17 17 17 17 0 0 8
8 0 0 17 17 17 17 17 17 11 17 17 17 14 17 17 17 0 0 8
8 0 0 17 17 17 17 17 17 17 17 14 17 17 17 17 17 0 0 8
8 0 0 17 17 17 14 17 17 17 17 17 17 17 17 17 17 0 0 8
8 0 0 17 17 17 17 17 17 17 17 17 17 17 22 17 17 0 0 8
8 0 0 17 17 11 17 17 11 17 17 17 17 17 17 17 17 0 0 8
8 0 0 17 17 17 17 17 17 17 17 14 17 17 17 17 17 0 0 8
8 0 0 17 17 17 17 17 17 17 17 17 17 17 17 17 17 0 0 8
8 0 0 17 17 20 17 17 11 17 17 17 17 17 17 8 17 0 0 8
8 0 0 17 17 17 17 17 17 17 17 21 17 11 17 8 21 0 0 8
8 0 0 17 17 17 17 17 17 17 17 17 17 17 17 8 8 0 0 8
8 0 0 17 8 8 8 17 17 20 17 14 17 17 17 17 17 0 0 8
8 0 0 17 17 17 17 17 17 17 17 17 17 17 17 17 17 0 0 8
8 0 0 17 17 17 17 17 17 14 17 17 17 17 17 17 17 0 0 8
8 0 0 17 17 17 17 17 17 17 17 17 17 17 17 17 17 0 0 8
8 0 0 17 17 17 17 17 17 17 17 17 17 11 17 17 17 0 0 8
8 0 0 17 17 17 17 17 17 17 17 17 17 17 14 17 17 0 0 8
8 0 0 17 14 17 17 17 11 17 17 17 17 17 17 17 17 0 0 8
8 0 0 17 17 17 17 17 17 17 17 17 17 17 17 17 17 0 0 8
8 0 0 17 17 17 17 17 17 17 17 17 14 17 17 17 17 0 0 8
8 0 0 17 17 17 14 17 17 17 17 17 17 17 17 17 17 0 0 8
8 0 0 17 17 17 17 17 17 14 17 17 17 17 17 17 17 0 0 8
8 0 0 17 17 17 17 17 17 17 17 11 17 17 17 17 17 0 0 8
8 0 0 17 17 17 17 17 17 17 17 17 17 17 17 21 17 0 0 8
8 0 0 17 17 17 17 17 17 17 17 17 17 17 17 17 17 0 0 8
8 0 0 17 17 22 17 17 17 12 17 17 17 17 17 17 17 0 0 8
8 0 0 17 17 17 17 17 17 17 17 17 17 17 17 17 17 0 0 8
