MapChip01.bmp
20 50
8 0 0 0 17 17 17 17 17 17 17 17 17 17 17 17 0 0 0 9
8 0 0 0 17 17 17 17 17 17 17 17 17 17 17 17 0 0 0 9
8 0 0 0 17 17 17 17 17 17 17 17 17 17 17 17 0 0 0 9
8 0 0 0 17 17 17 17 17 17 17 17 17 17 17 17 0 0 0 9
8 0 0 0 17 17 17 17 17 17 17 17 17 17 17 17 0 0 0 9
8 0 0 0 17 17 17 17 17 17 17 17 17 17 17 17 0 0 0 9
8 0 0 0 17 17 17 17 17 17 17 17 17 17 17 17 0 0 0 9
8 0 0 0 17 17 17 17 17 17 17 17 17 17 17 17 0 0 0 9
8 0 0 0 17 17 17 17 17 17 17 17 17 17 17 17 0 0 0 9
8 0 0 0 17 17 17 17 17 17 17 17 17 17 17 17 0 0 0 9
8 0 0 0 17 17 17 17 17 17 17 17 17 17 17 17 0 0 0 9
8 0 0 0 17 17 17 17 17 17 17 17 17 17 17 17 0 0 0 9
8 0 0 0 17 17 17 17 17 17 17 17 17 17 17 17 0 0 0 9
8 0 0 0 17 17 17 17 17 17 17 17 17 17 17 17 0 0 0 9
8 0 0 0 17 17 17 17 17 17 17 17 17 17 17 17 0 0 0 9
8 0 0 0 17 17 17 17 17 17 17 17 17 17 17 17 0 0 0 9
8 0 0 0 17 17 17 17 17 17 17 17 17 17 17 17 0 0 0 9
8 0 0 0 17 17 17 17 17 17 17 17 17 17 17 17 0 0 0 9
8 0 0 0 17 17 17 17 17 17 17 17 17 17 17 17 0 0 0 9
8 0 0 0 17 17 17 17 17 17 17 17 17 17 17 17 0 0 0 9
8 0 0 0 17 17 17 17 17 17 17 17 17 17 17 17 0 0 0 9
8 0 0 0 17 17 17 17 17 17 17 17 17 17 17 17 0 0 0 9
8 0 0 0 17 17 17 17 17 17 17 17 17 17 17 17 0 0 0 9
8 0 0 0 17 17 17 17 17 17 17 17 17 17 17 17 0 0 0 9
8 0 0 0 17 17 17 17 17 17 17 17 17 17 17 17 0 0 0 9
8 0 0 0 17 17 17 17 17 17 17 17 17 17 17 17 0 0 0 9
8 0 0 0 17 17 17 17 17 17 17 17 17 17 17 17 0 0 0 9
8 0 0 0 17 17 17 17 17 17 17 17 17 17 17 17 0 0 0 9
8 0 0 0 17 17 17 17 17 17 17 17 17 17 17 17 0 0 0 9
8 0 0 0 17 17 17 17 17 17 17 17 17 17 17 17 0 0 0 9
8 0 0 0 17 17 17 17 17 17 17 17 17 17 17 17 0 0 0 9
8 0 0 0 17 17 17 17 17 17 17 17 17 17 17 17 0 0 0 9
8 0 0 0 17 17 17 17 17 17 17 21 17 17 17 17 0 0 0 9
8 0 0 0 17 17 11 17 17 17 17 17 17 17 17 17 0 0 0 9
8 0 0 0 17 17 17 17 17 17 17 17 17 17 17 17 0 0 0 9
8 0 0 0 17 17 17 17 17 17 17 17 17 17 17 17 0 0 0 9
8 0 0 0 17 17 17 17 17 17 17 17 17 17 17 17 0 0 0 9
8 0 0 0 17 17 17 17 17 17 20 17 17 17 17 17 0 0 0 9
8 0 0 0 17 17 19 17 17 17 17 17 17 17 17 17 0 0 0 9
8 0 0 0 17 17 17 17 17 17 17 17 17 8 17 17 0 0 0 9
8 0 0 0 17 17 17 17 17 17 17 17 17 17 17 17 0 0 0 9
8 0 0 0 17 17 17 17 17 17 17 17 17 17 17 17 0 0 0 9
8 0 0 0 17 17 17 17 17 17 17 17 17 17 17 17 0 0 0 9
8 0 0 0 17 17 17 17 17 17 17 17 17 17 17 17 0 0 0 9
8 0 0 0 8 17 17 17 17 17 17 17 17 17 17 17 0 0 0 9
8 0 0 0 17 17 17 12 17 17 17 11 17 17 17 17 0 0 0 9
8 0 0 0 17 17 17 17 12 17 17 17 17 17 17 17 0 0 0 9
8 0 0 0 17 17 17 17 17 17 17 17 17 17 17 17 0 0 0 9
8 0 0 0 17 17 17 17 17 17 17 17 17 17 17 17 0 0 0 9
8 0 0 0 17 17 17 17 17 17 17 17 17 17 17 17 0 0 0 9
